['0','0','0','0','0','0','0','M','0','0'
'0','0','X','X','X','X','0','S','0','M'
'M','0','M','X','0','0','0','0','0','X'
'0','0','0','X','X','0','X','0','0','0'
'X','X','X','X','0','0','X','X','0','0'
'0','P','0','0','0','X','X','0','M','M'
'0','0','0','X','0','M','X','0','0','0']