['0','0','0','0','0','X','0','0','0','M'
'0','M','0','X','0','X','0','M','S','0'
'0','M','0','X','0','X','X','X','X','M'
'0','0','0','X','M','0','0','0','0','0'
'X','X','X','X','0','X','X','X','X','0'
'0','P','0','0','0','X','0','M','0','0'
'0','0','0','0','0','X','0','0','M','0']